+----------------------------
BBBBBBBBBBBBB
BRR         B
BR          B
B     0 1   B
B PP       SB
B PP       SB
B      W   SB
B      WW   B
BB         BB
 BBBBBBBBBBB
+----------------------------