+----------------------------
BBBBBBBBBBBBB
BRR         B
BR          B
B     001   B
B PP    1  SB
B PP       SB
B      W   SB
B      WW   B
BB         BB
 BBBBBBBBBBB
+----------------------------