+----------------------------
BBBBBBBBBBBBB
BRR         B
BR          B
B     0 1   B
B  P       SB
B  P       SB
B      W   SB
B      WW   B
BB         BB
 BBBBBBBBBBB
+----------------------------