+----------------------------
BBBBBBBBBBBBB
BR   PPP    B
BR   PPP    B
B           B
B         SSB
B          SB
B           B
B     0     B
BRR        RB
 BBBBBBBBBBB
+----------------------------