+----------------------------
BBBBBBBBBBBBB
BR          B
BR   P P    B
B           B
B  P      SSB
B  P       SB
B           B
B     0     B
BRR        RB
 BBBBBBBBBBB
+----------------------------