+----------------------------
BBBBBBBBBBBBBBBBBBBB
BRR   WWW          B
BR                 B
B     0            B
B             S    B
BP      1     SS   B
B                  B
B     WWW          B
B                  B
BBBBBBBBBBBBBBBBBBBB
+----------------------------