+----------------------------
BBBBBBBBBBBBB
BR          B
B     3301  B
B      221  B
B           B
B PP   R    B
B PP        B
BRR        RB
 BBBBBBBBBBB
+----------------------------